period,PD1,D1,Total1,PD2,D2,Total2,PD3,D3,Total3
3/1/1990,0,0,88,0,0,88,,0,0
6/1/1990,0,0,90,0,0,90,,0,0
9/1/1990,0,0,97,0,0,97,,0,0
12/1/1990,0,0,106,0,0,106,,0,0
3/1/1991,0,0,113,0,0,113,,0,0
6/1/1991,0,0,127,0,0,127,,0,0
9/1/1991,0,0,138,0,0,138,,0,0
12/1/1991,0,0,149,0,0,149,,0,0
3/1/1992,0,0,160,0,0,160,,0,0
6/1/1992,0,0,175,0,0,175,,0,0
9/1/1992,0,0,192,0,0,192,,0,0
12/1/1992,0,0,195,0,0,195,,0,0
3/1/1993,0,0,199,0,0,199,,0,0
6/1/1993,0,0,209,0,0,207,0,0,2
9/1/1993,0,0,208,0,0,206,0,0,2
12/1/1993,0,0,221,0,0,219,0,0,2
3/1/1994,0,0,228,0,0,227,0,0,1
6/1/1994,0,0,233,0,0,232,0,0,1
9/1/1994,0,0,243,0,0,242,0,0,1
12/1/1994,0,0,247,0,0,246,0,0,1
3/1/1995,0,0,243,0,0,242,0,0,1
6/1/1995,0.003787879,1,264,0.003787879,1,264,,0,0
9/1/1995,0.003472222,1,288,0,0,287,1,1,1
12/1/1995,0,0,300,0,0,300,,0,0
3/1/1996,0,0,316,0,0,316,,0,0
6/1/1996,0,0,325,0,0,323,0,0,2
9/1/1996,0,0,343,0,0,341,0,0,2
12/1/1996,0,0,354,0,0,352,0,0,2
3/1/1997,0,0,369,0,0,369,,0,0
6/1/1997,0,0,377,0,0,377,,0,0
9/1/1997,0,0,405,0,0,405,,0,0
12/1/1997,0.002398082,1,417,0.002398082,,417,,0,0
3/1/1998,0.004672897,2,428,0.00477327,2,419,0,0,9
6/1/1998,0.004484305,2,446,0.004576659,2,437,0,0,9
9/1/1998,0.008714597,4,459,0.004484305,2,446,0.153846154,2,13
12/1/1998,0.006465517,3,464,0.002222222,1,450,0.142857143,2,14
3/1/1999,0.004282655,2,467,0.002197802,1,455,0.083333333,1,12
6/1/1999,0.004158004,2,481,0.00212766,1,470,0.090909091,1,11
9/1/1999,0,0,479,0,0,470,0,0,9
12/1/1999,0,0,479,0,0,472,0,0,7
3/1/2000,0.00209205,1,478,0.002123142,1,471,0,0,7
6/1/2000,0.002053388,1,487,0.002083333,1,480,0,0,7
9/1/2000,0.00203252,1,492,0.002061856,1,485,0,0,7
12/1/2000,0.00204918,1,488,0.002074689,1,482,0,0,6
3/1/2001,0,0,476,0,0,471,0,0,5
6/1/2001,0.004192872,2,477,0.004237288,2,472,0,0,5
9/1/2001,0.008281573,4,483,0.004210526,2,475,0.25,2,8
12/1/2001,0.008403361,4,476,0.004282655,2,467,0.222222222,2,9
3/1/2002,0.008316008,4,481,0.00422833,2,473,0.25,2,8
6/1/2002,0.0041841,2,478,0.004237288,2,472,0,0,6
9/1/2002,0.002087683,1,479,0,0,472,0.142857143,1,7
12/1/2002,0.002087683,1,479,0,0,473,0.166666667,1,6
3/1/2003,0.002074689,1,482,0,0,476,0.166666667,1,6
6/1/2003,0.00203666,1,491,0,0,485,0.166666667,1,6
9/1/2003,0,0,496,0,0,491,0,0,5
12/1/2003,0,0,513,0,0,512,0,0,1
3/1/2004,0.001923077,1,520,0,0,519,1,1,1
6/1/2004,0.001941748,1,515,0,0,514,,1,1
9/1/2004,0.003809524,2,525,0.001908397,1,524,1,1,1
12/1/2004,0.003745318,2,534,0,0,532,1,2,2
3/1/2005,0,0,534,0,0,533,0,0,1
6/1/2005,0,0,540,0,0,540,,0,0
9/1/2005,0,0,544,0,0,544,,0,0
12/1/2005,0,0,566,0,0,566,,0,0
3/1/2006,0,0,575,0,0,575,,0,0
6/1/2006,0,0,577,0,0,577,,0,0
9/1/2006,0,0,578,0,0,577,0,0,1
12/1/2006,0,0,601,0,0,598,0,0,3
3/1/2007,0,0,565,0,0,562,0,0,3
6/1/2007,0,0,495,0,0,491,0,0,4
9/1/2007,0,0,502,0,0,496,0,0,6
12/1/2007,0.020283976,10,493,0.018480493,9,487,0.166666667,1,6
3/1/2008,0.026422764,13,492,0.024691358,12,486,0.166666667,1,6
6/1/2008,0.036885246,18,488,0.035343035,17,481,0.142857143,1,7
9/1/2008,0.040160643,20,498,0.032719836,16,489,0.44404444,4,9
12/1/2008,0.025104603,12,478,0.017094017,8,468,0.4,4,10
3/1/2009,0.018181818,9,495,0.012345679,6,486,0.333333333,3,9
6/1/2009,0.013972056,7,501,0.00814664,4,491,0.3,3,10
9/1/2009,0.013618677,7,514,0.005964215,3,503,0.363636364,4,11
12/1/2009,0.011450382,6,524,0.003898635,2,513,0.363636364,4,11
3/1/2010,0.012939002,7,541,0.009416196,5,531,0.2,2,10
6/1/2010,0.010989011,6,546,0.011173184,6,537,0,0,9
9/1/2010,0.012750455,7,549,0.011152416,6,538,0.090909091,1,11
12/1/2010,0.010380623,6,578,0.007130125,4,561,0.117647059,2,17
3/1/2011,0.006802721,4,588,0.001763668,1,567,0.142857143,3,21
6/1/2011,0.008143322,5,614,0,0,590,0.208333333,5,24
9/1/2011,0.008012821,5,624,0.00166113,1,602,0.181818182,4,22
12/1/2011,0.010719755,7,653,0.004754358,3,631,0.181818182,4,22
3/1/2012,0.012139605,8,659,0.007849294,5,637,0.136363636,3,22
6/1/2012,0.017910448,12,670,0.012383901,8,646,0.166666667,4,24
9/1/2012,0.020467836,14,684,0.013803681,9,652,0.15625,5,32
12/1/2012,0.017142857,12,700,0.00308642,2,648,0.192307692,10,52
3/1/2013,0.017216643,12,697,0.001545595,1,647,0.22,11,50
6/1/2013,0.011644833,8,687,0.001552795,1,644,0.162790698,7,43
9/1/2013,0.016296296,11,675,0.00792393,5,631,0.136363636,6,44
12/1/2013,0.016105417,11,683,0.007849294,5,637,0.130434783,6,46
3/1/2014,0.011577424,8,691,0.007692308,5,650,0.073170732,3,41
6/1/2014,0.011444921,8,699,0.00761035,5,657,0.071428571,3,42
9/1/2014,0.004255319,3,705,0,0,655,0.06,3,50
12/1/2014,0.011379801,8,703,0.00304414,2,657,0.130434783,6,46
3/1/2015,0.014388489,10,695,0.004601227,3,652,0.162790698,7,43
6/1/2015,0.01300578,9,692,0.003072197,2,651,0.170731707,7,41
9/1/2015,0.013024602,9,691,0.004587156,3,654,0.162162162,6,37
12/1/2015,0.005830904,4,686,0.003081664,2,649,0.054054054,2,37
3/1/2016,0.003012048,2,664,0,0,626,0.052631579,2,38
